11111111111111
11111C11111111
111111111P1111
11111111111111
11111111111111
1111E111111111
11111111111111