1111111111111
100100010C000
10010100000C1
100C011111001
1P0011E000001
1111111111111