1111111111111
100100011C101
10010100010C1
100C000000001
10P011E100001
1111111111111