1111111111111
100100010C001
10010100000C1
100C01A111001
10P011E100001
1111111111111