11111111111
1P000000001
11111111101
10000000101
101111C1101
101E0000101
10111111101
10000000001
11111111111