111111111111111111111111
1C00000000000000001100C1
10000000010000001CCC1001
10011111010000001CCC1001
1100C1010100000001110001
100CCC100100000C00000001
10000110110000CEC0000001
100000100100000C00000001
1C00C01C010000000E000PC1
111111111111111111111111