111111111111111111111111
1CCCCCCCCCCCCCCCCCCCCCC1
111111111101111111111111
1C000000000000000CCC0001
111111111111111111111101
100CCC000000000000000001
111111111111011111111111
100000000000000000000001
111110111111111111111111
1C0000000000000000E00PC1
111111111111111111111111