1111111111111
10M100010CM01
10010100M00C1
1CCC011111001
1PCC11E000001
1111111111111