111111111
1PC000001
100E00101
11C0000C1
111111111